//////////////
/            /
//L////////L//
//L////////L//
/  b     b   /
/////   //////
/     /      /
///L//////////
/ /L/   /    /
/ /L/   //L///
/ /L/    /L///
/          ///
//////////////
