//////////////
/   /    t   /
///L/     ////
/  L   t /////
/       //////
/////L////////
/       /    /
//L////////L//
/ L ////// L /
/  b     b   /
/////   //////
/     /      /
//////////////
