//////////////
/            /
//L////////L//
/ L ////// L /
/   b     b  /
//////   /////
/      /     /
//////////L///
/    t   /L/ /
/////    /L/ /
////// t  L  /
///////      /
//////////////
