//////////////
/            /
//L////////L//
//L////////L//
/  b     b   /
/////   //////
/     /      /
///L//////////
/ /L/   t    /
/ /L/    /////
/ /L/ t //////
/      ///////
//////////////
